{
  "version": "1.0",
  "metadata": {
    "name": "Warehouse Assault",
    "description": "A terrorist cell has taken over an abandoned warehouse. Breach the building, neutralize all hostiles, and rescue the hostages.",
    "author": "Official",
    "difficulty": "medium",
    "createdAt": "2025-01-01T00:00:00.000Z"
  },
  "settings": {
    "gridWidth": 40,
    "gridHeight": 30,
    "timeLimit": null
  },
  "objectives": {
    "eliminateEnemies": true,
    "rescueHostages": true,
    "reachExtraction": true,
    "custom": []
  },
  "grid": [
    [1,1,1,1,1,1,1,1,1,1,1,1,1,1,1,1,1,1,1,1,1,1,1,1,1,1,1,1,1,1,1,1,1,1,1,1,1,1,1,1],
    [1,2,0,0,0,0,1,0,0,0,0,0,0,0,0,0,0,0,0,0,0,0,0,0,0,0,0,0,0,0,0,0,0,1,0,0,0,0,0,1],
    [1,0,0,0,0,0,1,0,0,0,0,0,0,0,0,0,0,0,0,0,0,0,0,0,0,0,0,0,0,0,0,0,0,1,0,0,0,0,0,1],
    [1,0,0,0,0,0,1,0,0,3,0,0,0,0,3,0,0,0,0,0,0,0,0,3,0,0,0,0,3,0,0,0,0,1,0,0,0,0,0,1],
    [1,0,0,0,0,0,1,0,0,0,0,0,0,0,0,0,0,0,0,0,0,0,0,0,0,0,0,0,0,0,0,0,0,1,0,0,0,0,0,1],
    [1,0,0,0,0,0,0,0,0,0,0,0,0,0,0,0,0,0,0,0,0,0,0,0,0,0,0,0,0,0,0,0,0,0,0,0,0,0,0,1],
    [1,0,0,0,0,0,1,0,0,0,0,0,0,0,0,0,0,0,0,0,0,0,0,0,0,0,0,0,0,0,0,0,0,1,0,0,0,0,0,1],
    [1,1,1,1,1,1,1,0,0,0,0,0,0,0,0,0,0,0,0,0,0,0,0,0,0,0,0,0,0,0,0,0,0,1,1,1,0,1,1,1],
    [1,0,0,0,0,0,0,0,0,0,0,0,0,0,0,0,0,0,0,0,0,0,0,0,0,0,0,0,0,0,0,0,0,0,0,0,0,0,0,1],
    [1,0,0,0,0,0,0,0,0,0,0,0,0,0,0,0,0,0,0,0,0,0,0,0,0,0,0,0,0,0,0,0,0,0,0,0,0,0,0,1],
    [1,0,0,0,0,0,0,0,0,1,1,1,1,1,1,1,0,1,1,1,1,1,0,1,1,1,1,1,1,1,0,0,0,0,0,0,0,0,0,1],
    [1,0,0,0,0,0,0,0,0,1,0,0,0,0,0,0,0,0,0,0,0,0,0,0,0,0,0,0,0,1,0,0,0,0,0,0,0,0,0,1],
    [1,1,1,1,1,0,1,1,1,1,0,0,0,0,0,0,0,0,0,0,0,0,0,0,0,0,0,0,0,1,1,1,1,0,1,1,1,1,1,1],
    [1,0,0,0,0,0,0,0,0,1,0,0,3,0,0,0,0,0,0,0,0,0,0,0,0,3,0,0,0,1,0,0,0,0,0,0,0,0,0,1],
    [1,0,0,0,0,0,0,0,0,1,0,0,0,0,0,0,0,0,0,0,0,0,0,0,0,0,0,0,0,1,0,0,0,0,0,0,0,0,0,1],
    [1,0,0,0,3,0,0,0,0,0,0,0,0,0,0,0,0,0,0,0,0,0,0,0,0,0,0,0,0,0,0,0,0,0,0,3,0,0,0,1],
    [1,0,0,0,0,0,0,0,0,1,0,0,0,0,0,0,0,0,0,0,0,0,0,0,0,0,0,0,0,1,0,0,0,0,0,0,0,0,0,1],
    [1,0,0,0,0,0,0,0,0,1,0,0,0,0,0,3,0,0,0,0,0,3,0,0,0,0,0,0,0,1,0,0,0,0,0,0,0,0,0,1],
    [1,1,1,1,1,0,1,1,1,1,0,0,0,0,0,0,0,0,0,0,0,0,0,0,0,0,0,0,0,1,1,1,1,0,1,1,1,1,1,1],
    [1,0,0,0,0,0,0,0,0,1,0,0,0,0,0,0,0,0,0,0,0,0,0,0,0,0,0,0,0,1,0,0,0,0,0,0,0,0,0,1],
    [1,0,0,0,0,0,0,0,0,1,1,1,1,1,1,1,0,1,1,1,1,1,0,1,1,1,1,1,1,1,0,0,0,0,0,0,0,0,0,1],
    [1,0,0,0,0,0,0,0,0,0,0,0,0,0,0,0,0,0,0,0,0,0,0,0,0,0,0,0,0,0,0,0,0,0,0,0,0,0,0,1],
    [1,0,0,0,0,0,0,0,0,0,0,0,0,0,0,0,0,0,0,0,0,0,0,0,0,0,0,0,0,0,0,0,0,0,0,0,0,0,0,1],
    [1,0,0,0,0,0,0,0,0,0,0,0,0,0,0,0,0,0,0,0,0,0,0,0,0,0,0,0,0,0,0,0,0,0,0,0,0,0,0,1],
    [1,1,1,1,1,1,1,1,1,1,1,1,1,1,1,1,1,1,1,0,1,1,1,1,1,1,1,1,1,1,1,1,1,1,1,1,1,1,1,1],
    [1,0,0,0,0,0,0,0,0,0,0,0,0,0,0,0,0,0,0,0,0,0,0,0,0,0,0,0,0,0,0,0,0,0,0,0,0,0,0,1],
    [1,0,0,0,0,0,0,0,0,0,0,0,0,0,0,0,0,0,0,0,0,0,0,0,0,0,0,0,0,0,0,0,0,0,0,0,0,4,4,1],
    [1,0,0,0,0,0,0,0,0,0,0,0,0,0,0,0,0,0,0,0,0,0,0,0,0,0,0,0,0,0,0,0,0,0,0,0,0,4,4,1],
    [1,0,0,0,0,0,0,0,0,0,0,0,0,0,0,0,0,0,0,0,0,0,0,0,0,0,0,0,0,0,0,0,0,0,0,0,0,0,0,1],
    [1,1,1,1,1,1,1,1,1,1,1,1,1,1,1,1,1,1,1,1,1,1,1,1,1,1,1,1,1,1,1,1,1,1,1,1,1,1,1,1]
  ],
  "spawn": { "x": 1, "y": 1 },
  "entities": {
    "enemies": [
      { "x": 15, "y": 3, "type": "normal" },
      { "x": 25, "y": 3, "type": "normal" },
      { "x": 36, "y": 5, "type": "normal" },
      { "x": 15, "y": 13, "type": "normal" },
      { "x": 25, "y": 13, "type": "normal" },
      { "x": 20, "y": 17, "type": "heavy" },
      { "x": 5, "y": 22, "type": "normal" },
      { "x": 30, "y": 22, "type": "normal" }
    ],
    "civilians": [
      { "x": 18, "y": 14 },
      { "x": 22, "y": 14 },
      { "x": 36, "y": 3 }
    ],
    "doors": [
      { "x": 5, "y": 5, "locked": false },
      { "x": 5, "y": 12, "locked": true },
      { "x": 33, "y": 12, "locked": true },
      { "x": 5, "y": 18, "locked": false },
      { "x": 33, "y": 18, "locked": false },
      { "x": 16, "y": 10, "locked": false },
      { "x": 22, "y": 10, "locked": false },
      { "x": 16, "y": 20, "locked": false },
      { "x": 22, "y": 20, "locked": false },
      { "x": 36, "y": 7, "locked": true }
    ]
  },
  "rooms": [
    { "name": "Entry", "bounds": { "x": 1, "y": 1, "width": 5, "height": 6 } },
    { "name": "Main Warehouse", "bounds": { "x": 7, "y": 1, "width": 26, "height": 9 } },
    { "name": "Office", "bounds": { "x": 34, "y": 1, "width": 5, "height": 6 } },
    { "name": "Storage Room North", "bounds": { "x": 1, "y": 8, "width": 8, "height": 10 } },
    { "name": "Central Storage", "bounds": { "x": 10, "y": 11, "width": 19, "height": 9 } },
    { "name": "Storage Room South", "bounds": { "x": 30, "y": 8, "width": 9, "height": 10 } },
    { "name": "Exit Corridor", "bounds": { "x": 1, "y": 21, "width": 38, "height": 8 } }
  ]
}
